FRA	= "countries/France.txt"
PRC = "countries/ComChina.txt"
MAN = "countries/Manchukou.txt"
MEN = "countries/Mengkukuo.txt"
ZZZ = "countries/World Border.txt"
CHI = "countries/Peiyang Government.txt"
ANF = "countries/Anfu Clique.txt"
RAJ = "countries/British India.txt"
BRM = "countries/Burma.txt"
HND = "countries/India.txt"
PAK = "countries/Pakistan.txt"
SKM = "countries/Sikkim.txt"
INC = "countries/French Indochina.txt"
YUN = "countries/Yunnan.txt"
TIB = "countries/Tibet.txt"
SIK = "countries/Sinkiang.txt"
BHU = "countries/Bhutan.txt"
NEP = "countries/Nepal.txt"
AFG = "countries/Afghanistan.txt"
GUI = "countries/Kweichow.txt"
XKW = "countries/Szechuan Chingkuochun.txt"
JAP = "countries/Japan.txt"
LCH = "countries/21st Division.txt"
LXI = "countries/2nd Division.txt"
LWH = "countries/1st Mixed Brigade.txt"
LCX = "countries/4th Division.txt"
CXL = "countries/Chwampien.txt"
SQL = "countries/Nationalist Eastern Garrison.txt"
ZTD = "countries/Northeast Garrison.txt"
DMY = "countries/Dawu Clique.txt"
NUO = "countries/Nuosu.txt"
MUL = "countries/Muli.txt"
DAO = "countries/Daocheng.txt"
DRG = "countries/Derong.txt"
LIN = "countries/Lintsang.txt"
HOR = "countries/Hor Confederation.txt"
CSI = "countries/Chuosi.txt"
CKJ = "countries/Chuokechih.txt"
DGB = "countries/Dangba.txt"
SGG = "countries/Songgang.txt"
SUO = "countries/Suomu.txt"
NGW = "countries/Ngawa.txt"
SHM = "countries/Shimdrok.txt"
OWO = "countries/Powo.txt"
KOR = "countries/Korea.txt"
FMS = "countries/Formosa.txt"
RYU = "countries/Ryukyu.txt"
HUP = "countries/Hupeh.txt"
HCK = "countries/Hupeh Chingkuochun.txt"
SCK = "countries/Shensi Chingkuochun.txt"
CSC = "countries/Chensungchun.txt"
CYH = "countries/Shaanxi Clique.txt"
SHX = "countries/Shansi.txt"
ZHL = "countries/Chihli.txt"
ITA = "countries/Italy.txt"
BEL = "countries/Belgium.txt"
RUS = "countries/Russia.txt"
SOV = "countries/Soviet Union.txt"
YWA = "countries/Wa.txt"
MNG = "countries/Mangshi.txt"
GXC = "countries/Kwangsi.txt"
TWN = "countries/Tawang.txt"
SGY = "countries/Sagya.txt"
XNG = "countries/2nd Division.txt"
JNN = "countries/3rd Division.txt"
HNN = "countries/Hunan.txt"
FYX = "countries/16th Mixed Brigade.txt"
CJY = "countries/Yuanling Garrison.txt"
TYZ = "countries/West Hunan Clique.txt"
ZZF = "countries/Chihkiang Garrison.txt"
ZOW = "countries/Wukang Garrison.txt"
HEN = "countries/Honan.txt"
FKA = "countries/Fukien Chingkuochun.txt"
FKI = "countries/Fukien.txt"
KWN = "countries/Kwangtung.txt"
FDZ = "countries/FirstDefenceZone.txt"
SDZ = "countries/SecondDefenceZone.txt"
TDZ = "countries/ThirdDefenceZone.txt"
KSI = "countries/Kiangsi.txt"
KMT = "countries/Nationalist Government.txt"
ENG = "countries/Kulang Su Settlement.txt"
SHT = "countries/Shantung.txt"
CHY = "countries/Chiongya.txt"
POR = "countries/Macau.txt"
CPJ = "countries/Constitutional Protection Movement.txt"
CHK = "countries/Chekiang.txt"
HAI = "countries/Shanghai.txt"
JIA = "countries/Kiangsu.txt"
ANH = "countries/Anhwei Province.txt"
GER = "countries/Germany.txt"
PHI = "countries/Philippines.txt"
SIA = "countries/Siam.txt"
MON = "countries/Mongolia.txt"
GUF = "countries/Hulun.txt"
FNG = "countries/Fengtien.txt"
JEH = "countries/Rehe.txt"
HLK = "countries/Heilungkiang.txt"
KRN = "countries/Kirin.txt"
CHR = "countries/Chahar.txt"
SYN = "countries/Suiyuan.txt"
YBN = "countries/Yibin.txt"
DBT = "countries/Durbet.txt"
BRG = "countries/Barga.txt"
KHA = "countries/Kharchin.txt"
#KH2 = "countries/Kh2rchin.txt"
JUD = "countries/Jouda.txt"
KHO = "countries/Khorchin.txt"
GRL = "countries/Gorlos.txt"
JAL = "countries/Jalaid.txt"
SLG = "countries/Silingol.txt"
CAH = "countries/Chahar Tribe.txt"
DKB = "countries/Dorbod Khukhut.txt"
MMB = "countries/Mu Mingan.txt"
VLA = "countries/Vladivostok.txt"
USU = "countries/Ussuri.txt"
AMU = "countries/Amur.txt"
BRY  = "countries/Buryat-Mongolia.txt"
ALT = "countries/Karakorum-Altai.txt"
TAN = "countries/Tuva.txt"
FER = "countries/Far Eastern Republic.txt"
KAZ = "countries/Kazakhstan.txt"
UZB = "countries/Uzbekistan.txt"
TAJ = "countries/Tajikistan.txt"
KYR = "countries/Kyrgyzstan.txt"
ALS = "countries/Alash Orda.txt"
TRS = "countries/Turkestan.txt"
BAS = "countries/Basmachi.txt"
SMR = "countries/Semirechye.txt"
BUK = "countries/Bukhara.txt"
STE = "countries/White Mongolia.txt"
VIN = "countries/Vietnam.txt"
LAO = "countries/Laos.txt"
USA = "countries/United States.txt"
HAW = "countries/Hawaii.txt"
SHN = "countries/Shan.txt"
KML = "countries/Kumul Khanate.txt"
ETS = "countries/East Turkestan.txt"
YUS = "countries/Yushu Tribes.txt"
QNC = "countries/Kingdom of Nangchen.txt"
KSR = "countries/Khosorut League.txt"
LBR = "countries/Chiefdom of Labrang.txt"
QCH = "countries/Choni Chiefdom.txt"
WST = "countries/Wang Shidai Tribe.txt"
RGW = "countries/Rongwo Chiefdom.txt"
NGL = "countries/Ngolok Tribes.txt"
SWA = "countries/Sokwo Arik Tribe.txt"
XSM = "countries/Sining Ma Clique.txt"
NNG = "countries/Ningsia Ma Clique.txt"
CYE = "countries/Changye Clique.txt"
HSI = "countries/Hohsi Clique.txt"
GSU = "countries/Kansu Clique.txt"
NGR = "countries/Ngurla Chiefdom.txt"
NSC = "countries/New Sinkiang Clique.txt"
KKR = "countries/Kirei.txt"
KNI = "countries/Naimen.txt"
RSF = "countries/Russian SFSR.txt"
DUT = "countries/Ural-Orenberg.txt"
ATY = "countries/Altay.txt"
YNG = "countries/Yungning.txt"
DLI = "countries/New Yunnan Clique.txt"
HYD = "countries/Hyderabad.txt"
KSH = "countries/Kashmir.txt"
IND = "countries/Princley States.txt"
NGC = "countries/Li Zongren.txt"
LZH = "countries/Liu Zhenhuan.txt"
SHY = "countries/Shen Hongying.txt"
LVC = "countries/Lu Chao.txt"
YDJ = "countries/Yan Deji.txt"
XCY = "countries/Xiang Chuanyi.txt"
LSD = "countries/Lu Shidi.txt"
CHF = "countries/Chen Hongfan.txt"
SPG = "countries/Songpan Levy.txt"
WGX = "countries/Wu Guangxin.txt"
PUY = "countries/Forbidden City.txt"
OMG = "countries/Occupied Mongolia.txt"
YXM = "countries/Yuejiang.txt"
ALX = "countries/Alxa League.txt"
HEZ = "countries/Hezhou.txt"
GRM = "countries/Gansu Righteous Army.txt"
BAN = "countries/Gansu Bandits.txt"
ZYA = "countries/Zhongyi Army.txt"
LGD = "countries/Longdong Clique.txt"
SSG = "countries/Sanshenggong.txt"
WRX = "countries/White Xinjiang.txt"
HFJ = "countries/Hufajun.txt"
SHG = "countries/Shaoguan.txt"
JGM = "countries/Jiangmen.txt"
ZKR = "countries/Jiujiang.txt"
ANA = "countries/Anarchist.txt"
GIP = "countries/Wuzhou.txt"
MAY = "countries/Peking Revolutionaries.txt"
XIN = "countries/Xinyang.txt"
JIN = "countries/Jinan.txt"
SHI = "countries/Shiyi.txt"
FJG = "countries/Fujian Navy Garrison.txt"
YUL = "countries/Yulin Clique.txt"
DER = "countries/Derge.txt"
HON = "countries/Nageng.txt"
GEN = "countries/Gengma.txt"
CHH = "countries/Chiang Hung.txt"
RAG = "countries/Ragya.txt"
MPP = "countries/Red Mongolia.txt"
DQJ = "countries/Dingqianjun.txt"
ZHJ = "countries/Civilian Zhejiang.txt"
LID = "countries/Liaodong.txt"
FEN = "countries/Fengtian Province.txt"
CER = "countries/Far Eastern Army.txt"
BND = "countries/Dongbei Bandits.txt"
JLN = "countries/Jilin Province.txt"
GUO = "countries/Dongbei Guominjun.txt"
HEI = "countries/Heilongjiang Province.txt"
YGS = "countries/Sichuan 2nd Army.txt"
DXH = "countries/Sichuan 3rd Division.txt"
TSY = "countries/Sichuan 21st Division.txt"
#潮汕饮冰室 新增
MHF = "countries/MHF.txt"